{
  "name": "Earth (via custom map format)",
  "rows": [
    "WWWWWWWWWWWWWWWWWWWWWWWWWWWWWWWWWWWWWWWWWWWWWWWWWWWWWWWWWWWWWWWWWWWWWWWWWWWWWWWW",
    "WWWWWWWWWWWWWWWWWWWWWWWWWWWWWWWWWWWWWWWWWWWWWWWWWWWWWWWWWWWWWWWWWWWWWWWWWWWWWWWW",
    "WWWWWWWWWWWWWWWWWWWWWWWWWWWWWWWWWWWWWWWWWWWWWWWWWWWWWWWWWWWWWWWWWWWWWWWWWWWWWWWW",
    "WWWWWWWWWWWWWWWWWWWWWWWWWAAAAAAAWWWWWWWWWWWWWWWWWWWWWWWWWWWWWWWWWWWWWWWWWWWWWWWW",
    "WWWWWWWWWWWWWWWAAWAWAAAWAAAAAAAAWWWWWWAWWWWWGGWWWWWTAGWWWWWWWWWWWWWWWWWWWWWWWWWW",
    "WWWWTTTTAWWWWAAAAAAAAWWWWAAAAAATWWWWWAAWWWWWWWWWWWWWWWAAWWWWWTWWWWWWWWWWWWWWWWWW",
    "WWWTTTTTTTTTAAWAWAAAAAWWWAAAAATWWWWWWWWWWWWWWWAWWWWWFFAAFFFFFWWFFFWWWWFFFWWWWWWW",
    "WTPTGPPPPTTTTTWTAAAWWAWWWAAAATWWWWWWWWWWWWWWWAWWAAWFFGAFFFFFFFAFFFFFFFFFFWTWWWWW",
    "WWWWWPGTPTWWTTAAAAAAAAWWAAGGWWWWWWWWWWGAAWWWWWWGWGFFFGFFFFFFFFAFFAFFFFFGFGGWWWWW",
    "WWWWWGGFGPPTTAAWWWAWTWWWAGWWWWAWWWWWWAFGFPGFWAAFGTGFFFFFFFFFFFFFFFGFFGWGFFWWWWWW",
    "WWWWPMGFPPPPTTWWWATAAWWWWWWWWWWWWWWWGFPGGFWFFFFFFGFFFFFFFFFFFFFFGFFFFGWWFWWWWWWW",
    "WWWWPMGFGPPWTTTAATTTTWWWWWWWWWWHWWWPFGWGGGFFFGFGGGFFFFFFFFFFFFFFFFFFWWWWFGWWWWWW",
    "WWWWPHFFGPGWPPPWPTTTTWWWWWWWWWGRWWWWWPWGFGFFGFFFGFGFGGFGGFFFGFFFFFFFGWWWWPWWWWWW",
    "WWWWGGHFGPPPPPPPPPTPPWWWWWWWWWWFWWWFWWWFFFRFFFFRGFPFFPFGPFGFFWFFFFFGPPGWWWWWWWWW",
    "WWWGGGMGGGPPPWPPPPPWPWWWWWWWWWGGWWWGPPFFFGRRFRRRGGFGGGGGPGGFFFFDPPPPPPWWWWWWWWWW",
    "WWWGGFMGRGRPGWRRGWPWWWWWWWWWWWWWWGRGGGGFFGFRFRPGPGGGGGPPPPPPPPPPPPPPGPGWWWWWWWWW",
    "WWGGGMMGRGRGGGGWWWWWWWWWWWWWWWWWGGRMMGGGGPGRPRRPPPPPPPPPPPPPPPPPPPPPGPGWPGWWWWWW",
    "WWGGPPHGRRRGGGWWWWWWWWWWWWWWWWWWPGGGGFGRRGPRPDWWPPWPPPDPDDDPPPPPPDPPPGWWGWWWWWWW",
    "WWGFPPFGGRGGGPWWWWWWWWWWWWWWWWPPPPWGHWWGRFWWWHPWGPPDPDPDDPPPPPPDDPPWPGWWMGWWWWWW",
    "WWGPPDDGGRGGWWWWWWWWWWWWWWWWWWPPPWWWGHWWWGPPPPPWPPPPDPPHPDDDDDDPPPGWWWWWWPWWWWWW",
    "WWPWGDDPWWWPWWWWWWWWWWWWWWWWWWWWWWWWWGWWWWWPPPPGPPPPPPHHMHHHHHHHHMHPGWWGWWWWWWWW",
    "WWPWGDDWWWWPWWWWWWWWWWWWWWWWWWGPPDDWWWWWWWWPPRRHPPPDPPHPGHMMMMMHHHPPPGWWWWWWWWWW",
    "WWWWGDGWWWWWWWWWWWWWWWWWWWWWWWDPHHPPPGWDPWPPPGRRPPPPPHHRDPGMHHMHHPPRRRWWWWWWWWWW",
    "WWWWGGPWPWWWGPWWWWWWWWWWWWWWWPPHDDDPPPPDDRGDPPDWPPPPHPRRDGGGHHHHHPGPPPWWWWWWWWWW",
    "WWWWWGGPGWWWWGPWWWWWWWWWWWWWPPDDDDDPDDDDDRDWPDDWWWWHHRRDPGGRGGGHGPGGPWWWWWWWWWWW",
    "WWWWWWWWGGWWWWWWWWWWWWWWWWWWPDDDDDDDDDDDSRSWDDDDDDWWWWPPGGGRRPPGFGGGWWWGWWWWWWWW",
    "WWWWWWWWWGWWWWWWWWWWWWWWWWWPDDDDDDPPPDDDDRDWWPDDDDPWWWWGGGGGWWGGGGGWWWWPGWWWWWWW",
    "WWWWWWWWWPPWGPPGWWWWWWWWWWWDDDDDDDPDDDDDDRDDWWDDDDWWWWWWGGGWWWPPGGWWWWWGGWWWWWWW",
    "WWWWWWWWWWPGFPPPGWWWWWWWWWWDDDDDDDDPDPDPPDHHDWWPDWWWWWWWGGWWWWWGGGGWWWWWFGWWWWWW",
    "WWWWWWWWWWWGHGGGGGGWWWWWWWWPPDPPPPDDDPPPPPPMDPWWGWWWWWWWPGWWWWWWWGGWWWWWWGWWWWWW",
    "WWWWWWWWWWWHJJJGGGGRWWWWWWWWPPDPPPPPPPPPPPPHMDPWWWWWWWWWWGWWWWWWWWWWWPWWWWWWWWWW",
    "WWWWWWWWWWGHJRRJJRRRGWWWWWWWWPPPGWPPGPGGGGGGMDDPWWWWWWWWWWWWWWWWWWWGPPWWGPWWWWWW",
    "WWWWWWWWWWPGJJRRRRJGFGGWWWWWWWWWWWWGGGGJJJGGWDPPWWWWWWWWWWWWWWWGFGWWPGFGGGWGWWWW",
    "WWWWWWWWWWWFGGJJGJJFGGGPWWWWWWWWWWWGGJJRRRGGHPPWWWWWWWWWWWWWWWWWGFWWGWPGWWWPGGWW",
    "WWWWWWWWWWWGHGGGGGGGGGGWWWWWWWWWWWWGGRRRJJHWGGWWWWWWWWWWWWWWWWWWWGWWWWWWWWWWWGGW",
    "WWWWWWWWWWWWGMFGGGGGGPWWWWWWWWWWWWWWGRJJJGHMGWWWWWWWWWWWWWWWWWWWWPPWWWWWGWWWWWWW",
    "WWWWWWWWWWWWGFMGGFGPPPWWWWWWWWWWWWWWRRGGGGGMPWWWWWWWWWWWWWWWWWWWWWGWWWWWWWPGWWWW",
    "WWWWWWWWWWWWWWHMGGRPGGWWWWWWWWWWWWWWWGGGGGGHGWWWWWWWWWWWWWWWWWWWWWWWWWWGGPGPGGWW",
    "WWWWWWWWWWWWWWGHGGRGGWWWWWWWWWWWWWWWWDPPGGGGGGWWWWWWWWWWWWWWWWWWWWWWWWWGGPPPPGWW",
    "WWWWWWWWWWWWWWGMGPRRWWWWWWWWWWWWWWWWPPPPPPPGGGWPWWWWWWWWWWWWWWWWWWWWGGPPPDDDPPPW",
    "WWWWWWWWWWWWWWGMGGGPWWWWWWWWWWWWWWWWHPDDPPGGWWWPWWWWWWWWWWWWWWWWWWWGGGPDDDDDDPFW",
    "WWWWWWWWWWWWWWPMGGGWWWWWWWWWWWWWWWWWWPPDPPGGWWWGWWWWWWWWWWWWWWWWWWWGPDDDDDDDDPPW",
    "WWWWWWWWWWWWWWWMGPWWWWWWWWWWWWWWWWWWWHPPPGGGWWGPWWWWWWWWWWWWWWWWWWWGDDDDDPDDDPGW",
    "WWWWWWWWWWWWWWWGGWWWWWWWWWWWWWWWWWWWWHPPGHGWWWPWWWWWWWWWWWWWWWWWWWWDDDDDDDPDDHFW",
    "WWWWWWWWWWWWWWWPGWWWWWWWWWWWWWWWWWWWWWDPGHGWWWWWWWWWWWWWWWWWWWWWWWWDDDWWGDDDHGWW",
    "WWWWWWWWWWWWWWWWGWWWWWWWWWWWWWWWWWWWWWPGGGWWWWWWWWWWWWWWWWWWWWWWWWWWWWWWGHHHGWWW",
    "WWWWWWWWWWWWWWWWFWWWWWWWWWWWWWWWWWWWWWGWWWWWWWWWWWWWWWWWWWWWWWWWWWWWWWWWWWPGWWWW",
    "WWWWWWWWWWWWWWWWWWWWWWWWWWWWWWWWWWWWWWWWWWWWWWWWWWWWWWWWWWWWWWWWWWWWWWWWWWWWWWWW",
    "WWWWWWWWWWWWWWWWWWWWWWWWWWWWWWWWWWWWWWWWWWWWWWWWWWWWWWWWWWWWWWWWWWWWWWWWWWWWWWWW",
    "WWWWWWWWWWWWWWWWWWWWWWWWWWWWWWWWWWWWWWWWWWWWWWWWWWWWWWWWWWWWWWWWWWWWWWWWWWWWWWWW"
  ],
  "startPositions": {
    "Roman": [
      36,
      19
    ],
    "Babylonian": [
      45,
      22
    ],
    "German": [
      38,
      15
    ],
    "Egyptian": [
      41,
      24
    ],
    "American": [
      12,
      18
    ],
    "Greek": [
      39,
      18
    ],
    "Indian": [
      57,
      24
    ],
    "Russian": [
      44,
      12
    ],
    "Zulu": [
      42,
      42
    ],
    "French": [
      33,
      16
    ],
    "Aztec": [
      5,
      23
    ],
    "Chinese": [
      66,
      19
    ],
    "English": [
      31,
      14
    ],
    "Mongol": [
      49,
      19
    ]
  }
}