{
  "name": "Full",
  "rows": [
    "GGGGGGGGGGGGGGGGGGGGGGGGGGGGGGGGGGGGGGGGGGGGGGGGGGGGGGGGGGGGGGGGGGGGGGGGGGGGGGGG",
    "WWWWWGGGGGGGGGGGGGGGGGGGGGGGGGGGGGGGGGGGGGGGGGGGGGGGGGGGGGGGGGGGGGGGGGGGGGGGGGGG",
    "WWWWWGGGGGGGGGGGGGGGGGGGGGGGGGGGGGGGGGGGGGGGGGGGGGGGGGGGGGGGGGGGGGGGGGGGGGGGGGGG",
    "WWGWWGGGGGGGGGGGGGGGGGGGGAAAAAAAGGGGGGGGGGGGGGGGGGGGGGGGGGGGGGGGGGGGGGGGGGGGGGGG",
    "WWWWWGGGGGGGGGGAAGAGAAAGAAAAAAAAGGGGGGAGGGGGGGGGGGGTAGGGGGGGGGGGGGGGGGGGGGGGGGGG",
    "WWWWWTTTAGGGGAAAAAAAAGGGGAAAAAATGGGGGAAGGGGGGGGGGGGGGGAAGGGGGTGGGGGGGGGGGGGGGGGG",
    "GGGTTTTTTTTTAAGAGAAAAAGGGAAAAATGGGGGGGGGGGGGGGAGGGGGFFAAFFFFFGGFFFGGGGFFFGGGGGGG",
    "GTPTGPPPPTTTTTGTAAAGGAGGGAAAATGGGGGGGGGGGGGGGAGGAAGFFGAFFFFFFFAFFFFFFFFFFGTGGGGG",
    "GGGGGPGTPTGGTTAAAAAAAAGGAAGGGGGGGGGGGGGAAGGGGGGGGGFFFGFFFFFFFFAFFAFFFFFGFGGGGGGG",
    "GGGGGGGFGPPTTAAGGGAGTGGGAGGGGGAGGGGGGAFGFPGFGAAFGTGFFFFFFFFFFFFFFFGFFGGGFFGGGGGG",
    "GGGGPMGFPPPPTTGGGATAAGGGGGGGGGGGGGGGGFPGGFGFFFFFFGFFFFFFFFFFFFFFGFFFFGGGFGGGGGGG",
    "GGGGPMGFGPPGTTTAATTTTGGGGGGGGGGHGGGPFGGGGGFFFGFGGGFFFFFFFFFFFFFFFFFFGGGGFGGGGGGG",
    "GGGGPHFFGPGGPPPGPTTTTGGGGGGGGGGRGGGGGPGGFGFFGFFFGFGFGGFGGFFFGFFFFFFFGGGGGPGGGGGG",
    "GGGGGGHFGPPPPPPPPPTPPGGGGGGGGGGFGGGFGGGFFFRFFFFRGFPFFPFGPFGFFGFFFFFGPPGGGGGGGGGG",
    "GGGGGGMGGGPPPGPPPPPGPGGGGGGGGGGGGGGGPPFFFGRRFRRRGGFGGGGGPGGFFFFDPPPPPPGGGGGGGGGG",
    "GGGGGFMGRGRPGGRRGGPGGGGGGGGGGGGGGGRGGGGFFGFRFRPGPGGGGGPPPPPPPPPPPPPPGPGGGGGGGGGG",
    "GGGGGMMGRGRGGGGGGGGGGGGGGGGGGGGGGGRMMGGGGPGRPRRPPPPPPPPPPPPPPPPPPPPPGPGGPGGGGGGG",
    "GGGGPPHGRRRGGGGGGGGGGGGGGGGGGGGGPGGGGFGRRGPRPDGGPPGPPPDPDDDPPPPPPDPPPGGGGGGGGGGG",
    "GGGFPPFGGRGGGPGGGGGGGGGGGGGGGGPPPPGGHGGGRFGGGHPGGPPDPDPDDPPPPPPDDPPGPGGGMGGGGGGG",
    "GGGPPDDGGRGGGGGGGGGGGGGGGGGGGGPPPGGGGHGGGGPPPPPGPPPPDPPHPDDDDDDPPPGGGGGGGPGGGGGG",
    "GGPGGDDPGGGPGGGGGGGGGGGGGGGGGGGGGGGGGGGGGGGPPPPGPPPPPPHHMHHHHHHHHMHPGGGGGGGGGGGG",
    "GGPGGDDGGGGPGGGGGGGGGGGGGGGGGGGPPDDGGGGGGGGPPRRHPPPDPPHPGHMMMMMHHHPPPGGGGGGGGGGG",
    "GGGGGDGGGGGGGGGGGGGGGGGGGGGGGGDPHHPPPGGDPGPPPGRRPPPPPHHRDPGMHHMHHPPRRRGGGGGGGGGG",
    "GGGGGGPGPGGGGPGGGGGGGGGGGGGGGPPHDDDPPPPDDRGDPPDGPPPPHPRRDGGGHHHHHPGPPPGGGGGGGGGG",
    "GGGGGGGPGGGGGGPGGGGGGGGGGGGGPPDDDDDPDDDDDRDGPDDGGGGHHRRDPGGRGGGHGPGGPGGGGGGGGGGG",
    "GGGGGGGGGGGGGGGGGGGGGGGGGGGGPDDDDDDDDDDDSRSGDDDDDDGGGGPPGGGRRPPGFGGGGGGGGGGGGGGG",
    "GGGGGGGGGGGGGGGGGGGGGGGGGGGPDDDDDDPPPDDDDRDGGPDDDDPGGGGGGGGGGGGGGGGGGGGPGGGGGGGG",
    "GGGGGGGGGPPGGPPGGGGGGGGGGGGDDDDDDDPDDDDDDRDDGGDDDDGGGGGGGGGGGGPPGGGGGGGGGGGGGGGG",
    "GGGGGGGGGGPGFPPPGGGGGGGGGGGDDDDDDDDPDPDPPDHHDGGPDGGGGGGGGGGGGGGGGGGGGGGGFGGGGGGG",
    "GGGGGGGGGGGGHGGGGGGGGGGGGGGPPDPPPPDDDPPPPPPMDPGGGGGGGGGGPGGGGGGGGGGGGGGGGGGGGGGG",
    "GGGGGGGGGGGHJJJGGGGRGGGGGGGGPPDPPPPPPPPPPPPHMDPGGGGGGGGGGGGGGGGGGGGGGPGGGGGGGGGG",
    "GGGGGGGGGGGHJRRJJRRRGGGGGGGGGPPPGGPPGPGGGGGGMDDPGGGGGGGGGGGGGGGGGGGGPPGGGPGGGGGG",
    "GGGGGGGGGGPGJJRRRRJGFGGGGGGGGGGGGGGGGGGJJJGGGDPPGGGGGGGGGGGGGGGGFGGGPGFGGGGGGGGG",
    "GGGGGGGGGGGFGGJJGJJFGGGPGGGGGGGGGGGGGJJRRRGGHPPGGGGGGGGGGGGGGGGGGFGGGGPGGGGPGGGG",
    "GGGGGGGGGGGGHGGGGGGGGGGGGGGGGGGGGGGGGRRRJJHGGGGGGGGGGGGGGGGGGGGGGGGGGGGGGGGGGGGG",
    "GGGGGGGGGGGGGMFGGGGGGPGGGGGGGGGGGGGGGRJJJGHMGGGGGGGGGGGGGGGGGGGGGPPGGGGGGGGGGGGG",
    "GGGGGGGGGGGGGFMGGFGPPPGGGGGGGGGGGGGGRRGGGGGMPGGGGGGGGGGGGGGGGGGGGGGGGGGGGGPGGGGG",
    "GGGGGGGGGGGGGGHMGGRPGGGGGGGGGGGGGGGGGGGGGGGHGGGGGGGGGGGGGGGGGGGGGGGGGGGGGPGPGGGG",
    "GGGGGGGGGGGGGGGHGGRGGGGGGGGGGGGGGGGGGDPPGGGGGGGGGGGGGGGGGGGGGGGGGGGGGGGGGPPPPGGG",
    "GGGGGGGGGGGGGGGMGPRRGGGGGGGGGGGGGGGGPPPPPPPGGGGPGGGGGGGGGGGGGGGGGGGGGGPPPDDDPPPG",
    "GGGGGGGGGGGGGGGMGGGPGGGGGGGGGGGGGGGGHPDDPPGGGGGPGGGGGGGGGGGGGGGGGGGGGGPDDDDDDPFG",
    "GGGGGGGGGGGGGGPMGGGGGGGGGGGGGGGGGGGGGPPDPPGGGGGGGGGGGGGGGGGGGGGGGGGGPDDDDDDDDPPG",
    "GGGGGGGGGGGGGGGMGPGGGGGGGGGGGGGGGGGGGHPPPGGGGGGPGGGGGGGGGGGGGGGGGGGGDDDDDPDDDPGG",
    "GGGGGGGGGGGGGGGGGGGGGGGGGGGGGGGGGGGGGHPPGHGGGGPGGGGGGGGGGGGGGGGGGGGDDDDDDDPDDHFG",
    "GGGGGGGGGGGGGGGPGGGGGGGGGGGGGGGGGGGGGGDPGHGGGGGGGGGGGGGGGGGGGGGGGGGDDDGGGDDDHGGG",
    "GGGGGGGGGGGGGGGGGGGGGGGGGGGGGGGGGGGGGGPGGGGGGGGGGGGGGGGGGGGGGGGGGGGGGGGGGHHHGGGG",
    "GGGGGGGGGGGGGGGGFGGGGGGGGGGGGGGGGGGGGGGGGGGGGGGGGGGGGGGGGGGGGGGGGGGGGGGGGGPGGGGG",
    "GGGGGGGGGGGGGGGGGGGGGGGGGGGGGGGGGGGGGGGGGGGGGGGGGGGGGGGGGGGGGGGGGGGGGGGGGGGGGGGG",
    "GGGGGGGGGGGGGGGGGGGGGGGGGGGGGGGGGGGGGGGGGGGGGGGGGGGGGGGGGGGGGGGGGGGGGGGGGGGGGGGG",
    "GGGGGGGGGGGGGGGGGGGGGGGGGGGGGGGGGGGGGGGGGGGGGGGGGGGGGGGGGGGGGGGGGGGGGGGGGGGGGGGG"
  ],
  "startPositions": {
    "Roman": [
      2,
      3
    ]
  }
}