{
  "name": "Seven Isles",
  "rows": [
    "WWWWWWWWWWWWWWWWWWWWWWWWWWWWWWWWWWWWWWWWWWWWWWWWWWWWWWWWWWWWWWWWWWWWWWWWWWWWWWWW",
    "WWWWWWWWWWWWWWWWWWWWWWWWWWWWWWWWWWWWWWWWWWWWWWWWWWWWWWWWWWWWWWWWWWWWWWWWWWWWWWWW",
    "WWWWWWWWWWWWWWWWWWWWWWWWWWWWWWWWWWWWWWWWWWWWWWWWWWWWWWWWWWWWWWWWWWWWWWWWWWWWWWWW",
    "WWWWWWWWWWWWWWWWWWWWWWWWWWWWWWWWWWWWWWWWWWWWWWWWWWWWWWWWWWWWWWWWWWWWWWWWWWWWWWWW",
    "WWWWWWWWWWWWWWWWWWWWWWWWWWWWWWWWWWWWWWWWWWWWWWWWWWWWWWWWWWWWWWWWWWWWWWWWWWWWWWWW",
    "WWWWWWWWWWSWWWWWWWWWWWWWWWWWWWWWWWWWWWWWWWWWWWWWWWSWWWWWWWWWWWWWWWWWWWWWWWWWWWWW",
    "WWWWWWSSAAAAASSWWWWWWWWWWWWWWWSWWWWWWWWWWWWWWWSSJJJJJSSWWWWWWWWWWWWWWWSWWWWWWWWW",
    "WWWWWSAAAAAAAAASWWWWWWWWWWSSGPGPGSSWWWWWWWWWWSJJJJJJJJJSWWWWWWWWWWSSGPGPGSSWWWWW",
    "WWWWTTTTTTTTTTTTTWWWWWWWWSPGPGPGPGPSWWWWWWWWDDDDDDRDDDDDDWWWWWWWWSPGPGPGPGPSWWWW",
    "WWWSTTTTTTTTTTTTTSWWWWWWDDGPGPGPGPGTTWWWWWWSDDDDDDRDDDDDDSWWWWWWTTGPGPGPGPGDDWWW",
    "WWSPGPGPGPGPGPGPGPSWWWWSDDPGPGPGPGPTTSWWWWSPGPGPGPRPGPGPGPSWWWWSTTPGPGPGPGPDDSWW",
    "WWSGPGPGFFFFFGPGPGSWWWSJDDGPMMMMGPGTTASWWWSGPGPGPGRGPGPGPGSWWWSATTGPGHHHHPGDDJSW",
    "WWGPGPGPFFFFFPGPGPGWWWSJDDPGMMMMPGPTTASWWWGPGPHHGPRPGMMPGPGWWWSATTPGPHHHHGPDDJSW",
    "WWPGPGMMPGGGPHHGPGPWWWJJDDGPGPGPFFGTTAAWWWPGPGHHPGGGPMMGPGPWWWAATTGFFPGPGPGDDJJW",
    "WSGPGPMMGGGGGHHPGPGSWWJJDDPGPGGGFFPTTAAWWSGPGPHHGGGGGMMPGPGSWWAATTPFFGGGPGPDDJJW",
    "WWPGPGMMPGGGPHHGPGPWWSJJRRRRRGGGFFGTTAASWWPGPGHHPGGGPMMGPGPWWSAATTGFFGGGRRRRRJJS",
    "WWGPGPMMGPRPGHHPGPGWWWJJDDPGPGGGFFPTTAAWWWGPGPGPFFFFFPGPGPGWWWAATTPFFGGGPGPDDJJW",
    "WWSGPGPGPGRGPGPGPGSWWWJJDDGPGPGPFFGTTAAWWWSGPGPGFFFFFGPGPGSWWWAATTGFFPGPGPGDDJJW",
    "WWSPGPGPGPRPGPGPGPSWWWSJDDPGHHHHPGPTTASWWWSPGPGPGPGPGPGPGPSWWWSATTPGPMMMMGPDDJSW",
    "WWWSDDDDDDRDDDDDDSWWWWSJDDGPHHHHGPGTTASWWWWSTTTTTTTTTTTTTSWWWWSATTGPGMMMMPGDDJSW",
    "WWWWDDDDDDRDDDDDDWWWWWWSDDPGPGPGPGPTTSWWWWWWTTTTTTTTTTTTTWWWWWWSTTPGPGPGPGPDDSWW",
    "WWWWWSJJJJJJJJJSWWWWWWWWDDGPGPGPGPGTTWWWWWWWWSAAAAAAAAASWWWWWWWWTTGPGPGPGPGDDWWW",
    "WWWWWWSSJJJJJSSWWWWWWWWWWSPGPGPGPGPSWWWWWWWWWWSSAAAAASSWWWWWWWWWWSPGPGPGPGPSWWWW",
    "WWWWWWWWWWSWWWWWWWWWWWWWWWSSGPGPGSSWWWWWWWWWWWWWWWSWWWWWWWWWWWWWWWSSGPGPGSSWWWWW",
    "WWWWWWWWWWWWWWWWWWWWWWWWWWWWWWSWWWWWWWWWWWWWWWWWWWWWWWWWWWWWWWWWWWWWWWSWWWWWWWWW",
    "WWWWWWWWWWWWWWWWWWWWWWWWWWWWWWWWWWWWWWWWWWWWWWWWWWWWWWWWWWWWWWWWWWWWWWWWWWWWWWWW",
    "WWWWWWWWWWWWWWWWWWWWWWWWWWWWWWWWWWWWWWWWWWWWWWWWWWWWWWWWWWWWWWWWWWWWWWWWWWWWWWWW",
    "WWWWWWWWWWWWWWWWWWWWWWWWWWWWWWWWWWWWWWWWWWWSWWWWWWWWWWWWWWWWWWWWWWWWWWWWWWWWWWWW",
    "WWWWWWWWWWWWWWWWSWWWWWWWWWWWWWWWWWWWWWWSSJJJJJSSWWWWWWWWWWWWWWWWWWWWWWSWWWWWWWWW",
    "WWWWWWWWWWWWSSAAAAASSWWWWWWWWWWWWWWWWWSJJJJJJJJJSWWWWWWWWWWWWWWWWWSSGPGPGSSWWWWW",
    "WWWWWWWWWWWSAAAAAAAAASWWWWWWWWWWWWWWWDDDDDDRDDDDDDWWWWWWWWWWWWWWWSPGPGPGPGPSWWWW",
    "WWWWWWWWWWTTTTTTTTTTTTTWWWWWWWWWWWWWSDDDDDDRDDDDDDSWWWWWWWWWWWWWTTGPGPGPGPGDDWWW",
    "WWWWWWWWWSTTTTTTTTTTTTTSWWWWWWWWWWWSPGPGPGPRPGPGPGPSWWWWWWWWWWWSTTPGPGPGPGPDDSWW",
    "WWWWWWWWSPGPGPGPGPGPGPGPSWWWWWWWWWWSGPGPGPGRGPGPGPGSWWWWWWWWWWSATTGPGMMMMPGDDJSW",
    "WWWWWWWWSGPGPGFFFFFGPGPGSWWWWWWWWWWGPGPMMGPRPGHHPGPGWWWWWWWWWWSATTPGPMMMMGPDDJSW",
    "WWWWWWWWGPGPGPFFFFFPGPGPGWWWWWWWWWWPGPGMMPGGGPHHGPGPWWWWWWWWWWAATTGFFPGPGPGDDJJW",
    "WWWWWWWWPGPGHHPGGGPMMGPGPWWWWWWWWWSGPGPMMGGGGGHHPGPGSWWWWWWWWWAATTPFFGGGPGPDDJJW",
    "WWWWWWWSGPGPHHGGGGGMMPGPGSWWWWWWWWWPGPGMMPGGGPHHGPGPWWWWWWWWWSAATTGFFGGGRRRRRJJS",
    "WWWWWWWWPGPGHHPGGGPMMGPGPWWWWWWWWWWGPGPGPFFFFFPGPGPGWWWWWWWWWWAATTPFFGGGPGPDDJJW",
    "WWWWWWWWGPGPHHGPRPGMMPGPGWWWWWWWWWWSGPGPGFFFFFGPGPGSWWWWWWWWWWAATTGFFPGPGPGDDJJW",
    "WWWWWWWWSGPGPGPGRGPGPGPGSWWWWWWWWWWSPGPGPGPGPGPGPGPSWWWWWWWWWWSATTPGPHHHHGPDDJSW",
    "WWWWWWWWSPGPGPGPRPGPGPGPSWWWWWWWWWWWSTTTTTTTTTTTTTSWWWWWWWWWWWSATTGPGHHHHPGDDJSW",
    "WWWWWWWWWSDDDDDDRDDDDDDSWWWWWWWWWWWWWTTTTTTTTTTTTTWWWWWWWWWWWWWSTTPGPGPGPGPDDSWW",
    "WWWWWWWWWWDDDDDDRDDDDDDWWWWWWWWWWWWWWWSAAAAAAAAASWWWWWWWWWWWWWWWTTGPGPGPGPGDDWWW",
    "WWWWWWWWWWWSJJJJJJJJJSWWWWWWWWWWWWWWWWWSSAAAAASSWWWWWWWWWWWWWWWWWSPGPGPGPGPSWWWW",
    "WWWWWWWWWWWWSSJJJJJSSWWWWWWWWWWWWWWWWWWWWWWSWWWWWWWWWWWWWWWWWWWWWWSSGPGPGSSWWWWW",
    "WWWWWWWWWWWWWWWWSWWWWWWWWWWWWWWWWWWWWWWWWWWWWWWWWWWWWWWWWWWWWWWWWWWWWWSWWWWWWWWW",
    "WWWWWWWWWWWWWWWWWWWWWWWWWWWWWWWWWWWWWWWWWWWWWWWWWWWWWWWWWWWWWWWWWWWWWWWWWWWWWWWW",
    "WWWWWWWWWWWWWWWWWWWWWWWWWWWWWWWWWWWWWWWWWWWWWWWWWWWWWWWWWWWWWWWWWWWWWWWWWWWWWWWW",
    "WWWWWWWWWWWWWWWWWWWWWWWWWWWWWWWWWWWWWWWWWWWWWWWWWWWWWWWWWWWWWWWWWWWWWWWWWWWWWWWW"
  ],
  "startPositions": {
    "Russian": [
      9,
      14
    ],
    "Roman": [
      11,
      14
    ],
    "Indian": [
      30,
      14
    ],
    "Mongol": [
      30,
      16
    ],
    "Zulu": [
      51,
      14
    ],
    "Babylonian": [
      49,
      14
    ],
    "Chinese": [
      70,
      16
    ],
    "American": [
      70,
      14
    ],
    "Aztec": [
      17,
      37
    ],
    "Egyptian": [
      15,
      37
    ],
    "French": [
      42,
      36
    ],
    "German": [
      44,
      36
    ],
    "Greek": [
      70,
      36
    ],
    "English": [
      70,
      38
    ]
  }
}