{
  "name": "Seven Isles",
  "rows": [
    "WWWWWWWWWWWWWWWWWWWWWWWWWWWWWWWWWWWWWWWWWWWWWWWWWWWWWWWWWWWWWWWWWWWWWWWWWWWWWWWW",
    "WWWWWWWWWWWWWWWWWWWWWWWWWWWWWWWWWWWWWWWWWWWWWWWWWWWWWWWWWWWWWWWWWWWWWWWWWWWWWWWW",
    "WWWWWWWWWWWWWWWWWWWWWWWWWWWWWWWWWWWWWWWWWWWWWWWWWWWWWWWWWWWWWWWWWWWWWWWWWWWWWWWW",
    "WWWWWWWWWWWWWWWWWWWWWWWWWWWWWWWWWWWWWWWWWWWWWWWWWWWWWWWWWWWWWWWWWWWWWWWWWWWWWWWW",
    "WWWWWWWWWWWWWWWWWWWWWWWWWWWWWWWWWWWWWWWWWWWWWWWWWWWWWWWWWWWWWWWWWWWWWWWWWWWWWWWW",
    "WWWWWWWWWWGWWWWWWWWWWWWWWWWWWWWWWWWWWWWWWWWWWWWWWWGWWWWWWWWWWWWWWWWWWWWWWWWWWWWW",
    "WWWWWWGGAAAAAGGWWWWWWWWWWWWWWWGWWWWWWWWWWWWWWWGGJJJJJGGWWWWWWWWWWWWWWWGWWWWWWWWW",
    "WWWWWGAAAAAAAAAGWWWWWWWWWWGGGPGPGGGWWWWWWWWWWGJJJJJJJJJGWWWWWWWWWWGGGPGPGGGWWWWW",
    "WWWWTTTTTTTTTTTTTWWWWWWWWGPGPGPGPGPGWWWWWWWWDDDDDDRDDDDDDWWWWWWWWGPGPGPGPGPGWWWW",
    "WWWGTTTTTTTTTTTTTGWWWWWWDDGPGPGPGPGTTWWWWWWGDDDDDDRDDDDDDGWWWWWWTTGPGPGPGPGDDWWW",
    "WWGPGPGPGPGPGPGPGPGWWWWGDDPGPGPGPGPTTGWWWWGPGPGPGPRPGPGPGPGWWWWGTTPGPGPGPGPDDGWW",
    "WWGGPGPGFFFFFGPGPGGWWWGJDDGPMMMMGPGTTAGWWWGGPGPGPGRGPGPGPGGWWWGATTGPGHHHHPGDDJGW",
    "WWGPGPGPFFFFFPGPGPGWWWGJDDPGMMMMPGPTTAGWWWGPGPHHGPRPGMMPGPGWWWGATTPGPHHHHGPDDJGW",
    "WWPGPGMMPGGGPHHGPGPWWWJJDDGPGPGPFFGTTAAWWWPGPGHHPGGGPMMGPGPWWWAATTGFFPGPGPGDDJJW",
    "WGGPGPMMGGGGGHHPGPGGWWJJDDPGPGGGFFPTTAAWWGGPGPHHGGGGGMMPGPGGWWAATTPFFGGGPGPDDJJW",
    "WWPGPGMMPGGGPHHGPGPWWGJJRRRRRGGGFFGTTAAGWWPGPGHHPGGGPMMGPGPWWGAATTGFFGGGRRRRRJJG",
    "WWGPGPMMGPRPGHHPGPGWWWJJDDPGPGGGFFPTTAAWWWGPGPGPFFFFFPGPGPGWWWAATTPFFGGGPGPDDJJW",
    "WWGGPGPGPGRGPGPGPGGWWWJJDDGPGPGPFFGTTAAWWWGGPGPGFFFFFGPGPGGWWWAATTGFFPGPGPGDDJJW",
    "WWGPGPGPGPRPGPGPGPGWWWGJDDPGHHHHPGPTTAGWWWGPGPGPGPGPGPGPGPGWWWGATTPGPMMMMGPDDJGW",
    "WWWGDDDDDDRDDDDDDGWWWWGJDDGPHHHHGPGTTAGWWWWGTTTTTTTTTTTTTGWWWWGATTGPGMMMMPGDDJGW",
    "WWWWDDDDDDRDDDDDDWWWWWWGDDPGPGPGPGPTTGWWWWWWTTTTTTTTTTTTTWWWWWWGTTPGPGPGPGPDDGWW",
    "WWWWWGJJJJJJJJJGWWWWWWWWDDGPGPGPGPGTTWWWWWWWWGAAAAAAAAAGWWWWWWWWTTGPGPGPGPGDDWWW",
    "WWWWWWGGJJJJJGGWWWWWWWWWWGPGPGPGPGPGWWWWWWWWWWGGAAAAAGGWWWWWWWWWWGPGPGPGPGPGWWWW",
    "WWWWWWWWWWGWWWWWWWWWWWWWWWGGGPGPGGGWWWWWWWWWWWWWWWGWWWWWWWWWWWWWWWGGGPGPGGGWWWWW",
    "WWWWWWWWWWWWWWWWWWWWWWWWWWWWWWGWWWWWWWWWWWWWWWWWWWWWWWWWWWWWWWWWWWWWWWGWWWWWWWWW",
    "WWWWWWWWWWWWWWWWWWWWWWWWWWWWWWWWWWWWWWWWWWWWWWWWWWWWWWWWWWWWWWWWWWWWWWWWWWWWWWWW",
    "WWWWWWWWWWWWWWWWWWWWWWWWWWWWWWWWWWWWWWWWWWWWWWWWWWWWWWWWWWWWWWWWWWWWWWWWWWWWWWWW",
    "WWWWWWWWWWWWWWWWWWWWWWWWWWWWWWWWWWWWWWWWWWWGWWWWWWWWWWWWWWWWWWWWWWWWWWWWWWWWWWWW",
    "WWWWWWWWWWWWWWWWGWWWWWWWWWWWWWWWWWWWWWWGGJJJJJGGWWWWWWWWWWWWWWWWWWWWWWGWWWWWWWWW",
    "WWWWWWWWWWWWGGAAAAAGGWWWWWWWWWWWWWWWWWGJJJJJJJJJGWWWWWWWWWWWWWWWWWGGGPGPGGGWWWWW",
    "WWWWWWWWWWWGAAAAAAAAAGWWWWWWWWWWWWWWWDDDDDDRDDDDDDWWWWWWWWWWWWWWWGPGPGPGPGPGWWWW",
    "WWWWWWWWWWTTTTTTTTTTTTTWWWWWWWWWWWWWGDDDDDDRDDDDDDGWWWWWWWWWWWWWTTGPGPGPGPGDDWWW",
    "WWWWWWWWWGTTTTTTTTTTTTTGWWWWWWWWWWWGPGPGPGPRPGPGPGPGWWWWWWWWWWWGTTPGPGPGPGPDDGWW",
    "WWWWWWWWGPGPGPGPGPGPGPGPGWWWWWWWWWWGGPGPGPGRGPGPGPGGWWWWWWWWWWGATTGPGMMMMPGDDJGW",
    "WWWWWWWWGGPGPGFFFFFGPGPGGWWWWWWWWWWGPGPMMGPRPGHHPGPGWWWWWWWWWWGATTPGPMMMMGPDDJGW",
    "WWWWWWWWGPGPGPFFFFFPGPGPGWWWWWWWWWWPGPGMMPGGGPHHGPGPWWWWWWWWWWAATTGFFPGPGPGDDJJW",
    "WWWWWWWWPGPGHHPGGGPMMGPGPWWWWWWWWWGGPGPMMGGGGGHHPGPGGWWWWWWWWWAATTPFFGGGPGPDDJJW",
    "WWWWWWWGGPGPHHGGGGGMMPGPGGWWWWWWWWWPGPGMMPGGGPHHGPGPWWWWWWWWWGAATTGFFGGGRRRRRJJG",
    "WWWWWWWWPGPGHHPGGGPMMGPGPWWWWWWWWWWGPGPGPFFFFFPGPGPGWWWWWWWWWWAATTPFFGGGPGPDDJJW",
    "WWWWWWWWGPGPHHGPRPGMMPGPGWWWWWWWWWWGGPGPGFFFFFGPGPGGWWWWWWWWWWAATTGFFPGPGPGDDJJW",
    "WWWWWWWWGGPGPGPGRGPGPGPGGWWWWWWWWWWGPGPGPGPGPGPGPGPGWWWWWWWWWWGATTPGPHHHHGPDDJGW",
    "WWWWWWWWGPGPGPGPRPGPGPGPGWWWWWWWWWWWGTTTTTTTTTTTTTGWWWWWWWWWWWGATTGPGHHHHPGDDJGW",
    "WWWWWWWWWGDDDDDDRDDDDDDGWWWWWWWWWWWWWTTTTTTTTTTTTTWWWWWWWWWWWWWGTTPGPGPGPGPDDGWW",
    "WWWWWWWWWWDDDDDDRDDDDDDWWWWWWWWWWWWWWWGAAAAAAAAAGWWWWWWWWWWWWWWWTTGPGPGPGPGDDWWW",
    "WWWWWWWWWWWGJJJJJJJJJGWWWWWWWWWWWWWWWWWGGAAAAAGGWWWWWWWWWWWWWWWWWGPGPGPGPGPGWWWW",
    "WWWWWWWWWWWWGGJJJJJGGWWWWWWWWWWWWWWWWWWWWWWGWWWWWWWWWWWWWWWWWWWWWWGGGPGPGGGWWWWW",
    "WWWWWWWWWWWWWWWWGWWWWWWWWWWWWWWWWWWWWWWWWWWWWWWWWWWWWWWWWWWWWWWWWWWWWWGWWWWWWWWW",
    "WWWWWWWWWWWWWWWWWWWWWWWWWWWWWWWWWWWWWWWWWWWWWWWWWWWWWWWWWWWWWWWWWWWWWWWWWWWWWWWW",
    "WWWWWWWWWWWWWWWWWWWWWWWWWWWWWWWWWWWWWWWWWWWWWWWWWWWWWWWWWWWWWWWWWWWWWWWWWWWWWWWW",
    "WWWWWWWWWWWWWWWWWWWWWWWWWWWWWWWWWWWWWWWWWWWWWWWWWWWWWWWWWWWWWWWWWWWWWWWWWWWWWWWW"
  ],
  "startPositions": {
    "Russian": [
      9,
      14
    ],
    "Roman": [
      11,
      14
    ],
    "Indian": [
      30,
      14
    ],
    "Mongol": [
      30,
      16
    ],
    "Zulu": [
      51,
      14
    ],
    "Babylonian": [
      49,
      14
    ],
    "Chinese": [
      70,
      16
    ],
    "American": [
      70,
      14
    ],
    "Aztec": [
      17,
      37
    ],
    "Egyptian": [
      15,
      37
    ],
    "French": [
      42,
      36
    ],
    "German": [
      44,
      36
    ],
    "Greek": [
      70,
      36
    ],
    "English": [
      70,
      38
    ]
  }
}