{
  "name": "seven-isles-connected",
  "rows": [
    "WWWWWWWWWWWWWWWWWWWWWWWWWWWWWWWWWWWWWWWWWWWWWWWWWWWWWWWWWWWWWWWWWWWWWWWWWWWWWWWW",
    "WWWWWWWWWWWWWWWWWWWWWWWWWWWWWWWWWWWWWWWWWWWWWWWWWWWWWWWWWWWWWWWWWWWWWWWWWWWWWWWW",
    "WWWWWWWWWWWWWWWWWWWWWWWWWWWWWWWWWWWWWWWWWWWWWWWWWWWWWWWWWWWWWWWWWWWWWWWWWWWWWWWW",
    "WWWWWWWWWWWWWWWWWWWWWWWWWWWWWWWWWWWWWWWWWWWWWWWWWWWWWWWWWWWWWWWWWWWWWWWWWWWWWWWW",
    "WWWWWWWWWWWWWWWWWWWWWWWWWWWWWWWWWWWWWWWWWWWWWWWWWWWWWWWWWWWWWWWWWWWWWWWWWWWWWWWW",
    "WWWWWWWWWWSWWWWWWWWWWWWWWWWWWWWWWWWWWWWWWWWWWWWWWWSWWWWWWWWWWWWWWWWWWWWWWWWWWWWW",
    "WWWWWWSSAAAAASSWWWWWWWWWWWWWWWSWWWWWWWWWWWWWWWSSJJJJJSSWWWWWWWWWWWWWWWSWWWWWWWWW",
    "WWWWWSAAAAAAAAWSWWWWWWWWWWSSGPGPGSSWWWWWWWWWWSJJJJJJJJJSWWWWWWWWWWSSGPGPGSSWWWWW",
    "WWWWTTTTTTTWWWWWWWWWWWWWWSPGPGPGPGPSWWWWWWWWDDDDDDRDDDDDDWWWWWWWWSPGPGPGPGPSWWWW",
    "WWWSTTTTTTWWWWWTWWWWWWWWDDGPGPGPGPGTTWWWWWWWWWDDDDRDDDDDDSWWWWWWTTGPGPGPGPGDDWWW",
    "WWSPGPGPGWWWWWGPGPSWWWWSDDPGPGPGPGPTTSWWWWWWWWWWGPRPGPGPGPSWWWWSTTPGPGPGPGPDDSWW",
    "WWSGPGPGFWWWFGPGPGSWWWSJDDGPMMMMGPGTTASWWWSWPWWWWWRGPGPGPGSWWWSATTGPGHHWWPGDDJSW",
    "WWGPGPGPWWWFFPGPGPGWWWGJDDPGMMMMPGPTTASWWWGPGPWWWWWPGMMPGPGWWWSATTPGPHWWWWPDDJSW",
    "WGGGPGMWWWGGPHHGPGPWGGGGDDGPGPGPFFGTTAGGWWPGPGHHWWWWPMMGPGPWWWAATTGFFPWWWPGDDJJW",
    "GGGGGPMWWWGGGHHPGPGGGGGGDDPGPGGWWFPTTGGGGSGPGPHHGWWWGMMPGPGGGGGATTPFFWWWWGPDDJJW",
    "GGGGPGMWWWGGPHHGPGGGGGGJRRRRRWWWWWGTTAGGGGGGPGHHPWWWPMMGPGGGGGGGTTGFFWWWRRRRRJJG",
    "GGGPGPMMWPRPGHHPGGGGWWJJDDPWWWWWWFPTTAAGGGGGGPGPFFWWWPGPGPGGGGGATTPFWWWGPGPDDJGG",
    "WWSGPGPGPGRGPGPGPGGWWWJJDDWWWWWWFFGTTAAWWGGGPGPGFFWWWGPGPGSWWWAATTGWWWWPGPGDDJJG",
    "WWSPGPGPGPRPGPGPGPSWWWSJDWWWWHHHPGPTTASWWWSPGPGPGPGWGPGPGPSWWWSATTPWWWMMMGPDDJSW",
    "WWWSDDDDDDRDDDDDDSWWWWSJWWWPHHHHGPGTTASWWWWSTTTTTTTTTTTTTSWWWWSATTWWWMMMMPGDDJSW",
    "WWWWDDDDDDRDDDDDDWWWWWWSWWWGPGPGPGPTTSWWWWWWTTTTTTTTTTTTTWWWWWWSTWWWWGPGPGPDDSWW",
    "WWWWWSJJJJGJJJJSWWWWWWWWWWWPGPGPGPGTTWWWWWWWWSAAAAAAAGASWWWWWWWWWWWWGPGPGPGDDWWW",
    "WWWWWWSSJGGGJSSWWWWWWWWWWWPGPGPGPGGSWWWWWWWWWWSSAAAAGGGWWWWWWWWWWWWGPGPGPGPSWWWW",
    "WWWWWWWWWGGGWWWWWWWWWWWWWWGGGPGPGGGGGWWWWWWWWWWWWWSWGGGWWWWWGWWWWWSSGPGPGSSWWWWW",
    "WWWWWWWWWGGGWWWWWWWWWWWWWGGGGWSWWWGGGGWWWWWWWWWWWWWGGGWWWWWGGGWWWWWWWGGGWWWWWWWW",
    "WWWWWWWWGGGGWWWWWWWWWWWGGGGGWWWWWWWGGGGWWWWWWWWWWWGGGGWWWWWWGWWWWWWWGGGGWWWWWWWW",
    "WWWWWWWWGGGWWWWWWWWWWWGGGGGWWWWWWWWWGGGGWWWWWWWWWGGGGWWWWWWWWWWWWWWWGGGWWWWWWWWW",
    "WWWWWWWGGGGGWWWWWWWWWWGGGGWWWWWWWWWWWGGGGWWSWWWGGGGGWWWWWWWWWWWWWWWWWGGGWWWWWWWW",
    "WWWWWWGGGGGGWWWWSWWWWGGGWWWWWWWWWWWWWWGGGJJJJJGGGGWWWWWWWWWWWWWWWWWWWWGGGWWWWWWW",
    "WWWWWGGGWGGGGSAAAAASGGGWWWWWWWWWWWWWWWSGJJJJJJJGGWWWWWWWWWWWWWWWWWSSGPGGGSSWWWWW",
    "WWWWGGGWWWGGGGAAAAAGGGWWWWWWWWWWWWWWWDDDDDDRDDDDWWWWWWWWWWWWWWWWWWWGPGPGPGPSWWWW",
    "WWWGWGWWWWTTGTTTTTTTGTTWWWWWWWWWWWWWSDDDDDDRDDWWWWWWWWWWWWWWWWWWWWWPGPGPGPGDDWWW",
    "GGGGGWWWWWWTTTTTTTTTTTTSWWWWWWWWWWWSPGPGPGPRWWWWWWPSWWWWWWWWWWWSTWWWPGPGPGPDDSWW",
    "GGGGGGGWWWWWGPGPGPGPGPGPSWWWWWWWWWWSGPGPGPGWWWWWGPGSWWWWWWWWWWSATTWWWMMMMPGDDJSG",
    "GGGGGGWWWWWWWGFFFFFGPGPGSWWWWWWWWWWGPGPMMGPWWWHHPGPGWWWWWWGGGWSATTWWWMMMMGPDDJGG",
    "GWWGGWWWGPWWWWFFFFFPGPGPGWWGGGGWWWWPGPGMMPWWWPHHGPGPWWWGWGGGGGGATTGWWWGPGPGDDJJG",
    "WWWWWWWGPGPWWWWWGGPMMGPGPGGGGGGWWWSGPGPMMWWWWGHHPGPGGGGGGGGGGGGGTTPFWWWGPGPDDJJW",
    "WWWWWWWSGPGPHWWWWGGMMPGPGGGGGGGWWWGGGPGMMWWWGPHHGPGGGGGGGGGGGGGGGTGFWWWGRRRRRJJS",
    "WWWWWWWWPGPGHHWWWGPMMGPGGGGWWWWWWGGGGGPGPWWWFFPGPGPGGGWWWWWWWWGGTTPFFWWWWGPDDJJW",
    "WWWWWWWWGPGPHHGWWWGMMPGPGWWWWWWWWGGGGPGPGFWFFFGPGPGSWWWWWWWWWWAATTGFFWWWWWGDDJJW",
    "WWWWWWWWSGPGPGPWWWPGPGPGSWWWWWWWWWWSPGPGPGPGPGPGPGPSWWWWWWWWWWSATTPGPHWWWGPDDJSW",
    "WWWWWWWWSPGPGPGPWPGPGPGPSWWWWWWWWWWWSTTTTTTTTTTTTTSWWWWWWWWWWWSATTGPGHHHHPGDDJSW",
    "WWWWWWWWWSDDDDDDRDDDDDDSWWWWWWWWWWWWWTTTTTTTTTTTTTWWWWWWWWWWWWWSTTPGPGPGPGPDDSWW",
    "WWWWWWWWWWDDDDDDRDDDDDDWWWWWWWWWWWWWWWSAAAAAAAAASWWWWWWWWWWWWWWWTTGPGPGPGPGDDWWW",
    "WWWWWWWWWWWSJJJJJJJJJSWWWWWWWWWWWWWWWWWSSAAAAASSWWWWWWWWWWWWWWWWWSPGPGPGPGPSWWWW",
    "WWWWWWWWWWWWSSJJJJJSSWWWWWWWWWWWWWWWWWWWWWWSWWWWWWWWWWWWWWWWWWWWWWSSGPGPGSSWWWWW",
    "WWWWWWWWWWWWWWWWSWWWWWWWWWWWWWWWWWWWWWWWWWWWWWWWWWWWWWWWWWWWWWWWWWWWWWSWWWWWWWWW",
    "WWWWWWWWWWWWWWWWWWWWWWWWWWWWWWWWWWWWWWWWWWWWWWWWWWWWWWWWWWWWWWWWWWWWWWWWWWWWWWWW",
    "WWWWWWWWWWWWWWWWWWWWWWWWWWWWWWWWWWWWWWWWWWWWWWWWWWWWWWWWWWWWWWWWWWWWWWWWWWWWWWWW",
    "WWWWWWWWWWWWWWWWWWWWWWWWWWWWWWWWWWWWWWWWWWWWWWWWWWWWWWWWWWWWWWWWWWWWWWWWWWWWWWWW"
  ],
  "startPositions": {
  }
}