{
  "name": "Test Island",
  "rows": [
    "WWWWWWWWWWWWWWWWWWWWWWWWWWWWWWWWWWWWWWWWWWWWWWWWWWWWWWWWWWWWWWWWWWWWWWWWWWWWWWWW",
    "WWWWWWWWWWWWWWWWWWWWWWWWWWWWWWWWWWWWWWWWWWWWWWWWWWWWWWWWWWWWWWWWWWWWWWWWWWWWWWWW",
    "WWWWWWWWWWWWWWWWWWWWWWWWWWWWWWWWWWWWWWWWWWWWWWWWWWWWWWWWWWWWWWWWWWWWWWWWWWWWWWWW",
    "WWWWWWWWWWWWWWWWWWWWWWWWWWWWWWWWWWWWWWWWWWWWWWWWWWWWWWWWWWWWWWWWWWWWWWWWWWWWWWWW",
    "WWWWWWWWWWWWWWWWWWWWWWWWWWWWWWWWWWWWWWWWWWWWWWWWWWWWWWWWWWWWWWWWWWWWWWWWWWWWWWWW",
    "WWWWWWWWWWWWWWWWWWWWWWWWWWWWWWWWWWWWWWWWWWWWWWWWWWWWWWWWWWWWWWWWWWWWWWWWWWWWWWWW",
    "WWWWWWWWWWWWWWWWWWWWWWWWWWWWWWWWWWWWWWWWWWWWWWWWWWWWWWWWWWWWWWWWWWWWWWWWWWWWWWWW",
    "WWWWWWWWWWWWWWWWWWWWWWWWWWWWWWWWWWWWWWWWWWWWWWWWWWWWWWWWWWWWWWWWWWWWWWWWWWWWWWWW",
    "WWWWWWWWWWWWWWWWWWWWWWWWWWWWWWWWWWWWWWWWWWWWWWWWWWWWWWWWWWWWWWWWWWWWWWWWWWWWWWWW",
    "WWWWWWWWWWWWWWWWWWWSSSSSSSSSSSSSSSSSSSSSSSSSSSSSSSSSSSSSSWWWWWWWWWWWWWWWWWWWWWWW",
    "WWWWWWWWWWWWWWWWWWWSAAAAAAAAAAAAAAAAAAAAAAAAAAAAAAAAAAAASWWWWWWWWWWWWWWWWWWWWWWW",
    "WWWWWWWWWWWWWWWWWWWSAAAAAAAAAAAAAAAAAAAAAAAAAAAAAAAAAAAASWWWWWWWWWWWWWWWWWWWWWWW",
    "WWWWWWWWWWWWWWWWWWWSAAAAAAAAAAAAAAAAAAAAAAAAAAAAAAAAAAAASWWWWWWWWWWWWWWWWWWWWWWW",
    "WWWWWWWWWWWWWWWWWWWSAAAAAAAAAAAAAAAAAAAAAAAAAAAAAAAAAAAASWWWWWWWWWWWWWWWWWWWWWWW",
    "WWWWWWWWWWWWWWWWWWWSAAAAAAAAAAAAAAAAAAAAAAAAAAAAAAAAAAAASWWWWWWWWWWWWWWWWWWWWWWW",
    "WWWWWWWWWWWWWWWWWWWSTTTTTTTTTTTTTTTTTTTTTTTTTTTTTTTTTTTTSWWWWWWWWWWWWWWWWWWWWWWW",
    "WWWWWWWWWWWWWWWWWWWSTTTTTTTTTTTTTTTTTTTTTTTTTTTTTTTTTTTTSWWWWWWWWWWWWWWWWWWWWWWW",
    "WWWWWWWWWWWWWWWWWWWSTTTTTTTTTTTTTTTTTTTTTTTTTTTTTTTTTTTTSWWWWWWWWWWWWWWWWWWWWWWW",
    "WWWWWWWWWWWWWWWWWWWSTTTTTTTTTTTTTTTTTTTTTTTTTTTTTTTTTTTTSWWWWWWWWWWWWWWWWWWWWWWW",
    "WWWWWWWWWWWWWWWWWWWSGGFFFFFFFFHHHHMMMMMMMMHHHHGGGGGGGGGGSWWWWWWWWWWWWWWWWWWWWWWW",
    "WWWWWWWWWWWWWWWWWWWSGGFFFFFFFFHHHHMMMMRMMMHHHHGGGGGGGGGGSWWWWWWWWWWWWWWWWWWWWWWW",
    "WWWWWWWWWWWWWWWWWWWSGGFFFFFFFFHHHHMMMMRMMMHHHHGGGGGGGGGGSWWWWWWWWWWWWWWWWWWWWWWW",
    "WWWWWWWWWWWWWWWWWWWSGGFFFFFFFFHHHHMMMMRMMMHHHHGGGGGGGGGGSWWWWWWWWWWWWWWWWWWWWWWW",
    "WWWWWWWWWWWWWWWWWWWSGGFFFFFFFFHHHHMMMMRMMMHHHHGGGGGGGGGGSWWWWWWWWWWWWWWWWWWWWWWW",
    "WWWWWWWWWWWWWWWWWWWSGGFFFFFFFFHHHHMMMMRMMMHHHHGGGGGGGGGGSWWWWWWWWWWWWWWWWWWWWWWW",
    "WWWWWWWWWWWWWWWWWWWSGGGGGGGGGGHHHHMMMMRMMMHHHHFFFFFFFFGGSWWWWWWWWWWWWWWWWWWWWWWW",
    "WWWWWWWWWWWWWWWWWWWSGGGGGGGGGGHHHHMMMMRMMMHHHHFFFFFFFFGGSWWWWWWWWWWWWWWWWWWWWWWW",
    "WWWWWWWWWWWWWWWWWWWSGGGGGGGGGGHHHHMMMMRMMMHHHHFFFFFFFFGGSWWWWWWWWWWWWWWWWWWWWWWW",
    "WWWWWWWWWWWWWWWWWWWSGGGGGGGGGGHHHHMMMMRMMMHHHHFFFFFFFFGGSWWWWWWWWWWWWWWWWWWWWWWW",
    "WWWWWWWWWWWWWWWWWWWSGGGGGGGGGGHHHHMMMMRMMMHHHHFFFFFFFFGGSWWWWWWWWWWWWWWWWWWWWWWW",
    "WWWWWWWWWWWWWWWWWWWSDDDDDDDDDDDDDDDDDDRDDDDDDDDDDDDDDDDDSWWWWWWWWWWWWWWWWWWWWWWW",
    "WWWWWWWWWWWWWWWWWWWSDDDDDDDDDDDDDDDDDDRDDDDDDDDDDDDDDDDDSWWWWWWWWWWWWWWWWWWWWWWW",
    "WWWWWWWWWWWWWWWWWWWSDDDDDDDDDDDDDDDDDDRDDDDDDDDDDDDDDDDDSWWWWWWWWWWWWWWWWWWWWWWW",
    "WWWWWWWWWWWWWWWWWWWSDDDDDDDDDDDDDDDDDDRDDDDDDDDDDDDDDDDDSWWWWWWWWWWWWWWWWWWWWWWW",
    "WWWWWWWWWWWWWWWWWWWSPPPPPPPPPPPPPPPPPPRPPPPPPPPPPPPPPPPPSWWWWWWWWWWWWWWWWWWWWWWW",
    "WWWWWWWWWWWWWWWWWWWSPPPPPPPPPPPPPPPPPPRPPPPPPPPPPPPPPPPPSWWWWWWWWWWWWWWWWWWWWWWW",
    "WWWWWWWWWWWWWWWWWWWSPPPPPPPPPPPPPPPPPPRPPPPPPPPPPPPPPPPPSWWWWWWWWWWWWWWWWWWWWWWW",
    "WWWWWWWWWWWWWWWWWWWSJJJJJJJJJJJJJJJJJJRJJJJJJJJJJJJJJJJJSWWWWWWWWWWWWWWWWWWWWWWW",
    "WWWWWWWWWWWWWWWWWWWSJJJJJJJJJJJJJJJJJJRJJJJJJJJJJJJJJJJJSWWWWWWWWWWWWWWWWWWWWWWW",
    "WWWWWWWWWWWWWWWWWWWSJJJJJJJJJJJJJJJJJJRJJJJJJJJJJJJJJJJJSWWWWWWWWWWWWWWWWWWWWWWW",
    "WWWWWWWWWWWWWWWWWWWSJJJJJJJJJJJJJJJJJJRJJJJJJJJJJJJJJJJJSWWWWWWWWWWWWWWWWWWWWWWW",
    "WWWWWWWWWWWWWWWWWWWSSSSSSSSSSSSSSSSSSSSSSSSSSSSSSSSSSSSSSWWWWWWWWWWWWWWWWWWWWWWW",
    "WWWWWWWWWWWWWWWWWWWWWWWWWWWWWWWWWWWWWWWWWWWWWWWWWWWWWWWWWWWWWWWWWWWWWWWWWWWWWWWW",
    "WWWWWWWWWWWWWWWWWWWWWWWWWWWWWWWWWWWWWWWWWWWWWWWWWWWWWWWWWWWWWWWWWWWWWWWWWWWWWWWW",
    "WWWWWWWWWWWWWWWWWWWWWWWWWWWWWWWWWWWWWWWWWWWWWWWWWWWWWWWWWWWWWWWWWWWWWWWWWWWWWWWW",
    "WWWWWWWWWWWWWWWWWWWWWWWWWWWWWWWWWWWWWWWWWWWWWWWWWWWWWWWWWWWWWWWWWWWWWWWWWWWWWWWW",
    "WWWWWWWWWWWWWWWWWWWWWWWWWWWWWWWWWWWWWWWWWWWWWWWWWWWWWWWWWWWWWWWWWWWWWWWWWWWWWWWW",
    "WWWWWWWWWWWWWWWWWWWWWWWWWWWWWWWWWWWWWWWWWWWWWWWWWWWWWWWWWWWWWWWWWWWWWWWWWWWWWWWW",
    "WWWWWWWWWWWWWWWWWWWWWWWWWWWWWWWWWWWWWWWWWWWWWWWWWWWWWWWWWWWWWWWWWWWWWWWWWWWWWWWW",
    "WWWWWWWWWWWWWWWWWWWWWWWWWWWWWWWWWWWWWWWWWWWWWWWWWWWWWWWWWWWWWWWWWWWWWWWWWWWWWWWW"
  ],
  "startPositions": {
    "Roman": [
      25,
      34
    ],
    "Egyptian": [
      50,
      12
    ]
  }
}